######################################################################
#            \||______________//*\\______________||                  #
#             ||=============//***\\=============||                  #
#             || -  -    -  //*****\\ -   -  -   ||                  #
#             ||     -   -  ||=====||-  -  --   -||                  #
#             || - -   -    ||     ||-  -    -   ||                  #
#             ||============||_[@]_||============||                  #
#                  ~~~~~~~~//.......\\~~~~~~~~~~~~~~~~               #
#                ~~~~~~~~~//.........\\~~~~~~~~~~~~~~~~~~            #
#              ~~~~~~~~~~//...........\\~~~~~~~~~~~~~~~~~~           #
#             ~~~~~~~~\\\\\\\........///////~~~~~~~~~~~~~~~          #
#            ~~~~~~~~~\\..................../~~~~~~~~~~~~~~~~~       #
#          ~~~~~~~~~~\......................./~~~~~~~~~~~~~~~~       #
#         ~~~~~~~~~~~\......................../~~~~~~~~~~~~~~~~      #
#        ~~~~~~~~~~~\....................'"`.../~~~~~~~~~~~~~        #
#       ~~~~~~~~~~~\.........................../~~~~~~~~~~~~~        #
#       ~~~~~~~~~~\............................./~~~~~~~~~~~~~       #
#        ~~~~~~~~\...............................//~~~~~~~~          #
#          ~~~~~~\...............................//~~~~~~~           #
#          ~~~~~\................................../~~~~~            #
#        ~~~~~~\..................................../~~~             #
######################################################################
