######################################################################
#...#..........#..#.....##....###...#....##...#....#..#...#.####...#.#
#.#...#######..##.#..#..##..#...#.#...#.#.#..#...#......#.....#..#...#
#..#.##...# #........#..#...#######.#.....#....#...#..#..###.....#...#
##.#..#.#..##  ## ####....#.....#...##..#.##########..##########.....#
#..##.#.#.#####......#. #.#.........#..#..#.................#...####.#
#.####..#.....########...........~~~###...##########..#####.#..#.....#
#.#.#..######.#.....########...~~~~~##[%].#...............#.....# [%]#
#.#..........##..#..........~~~~~~~~##################################
#.########.#..#..#...#######~~~~~~~~................................%#
#...........#...##............~~~~~~................................%#
#############....#...#######..~~~~~~##################################
#...........#....#.........#...~~~~~#                                #
#....|  |...#....#.........#....~~~~#                                #
#########...#..............#.......~#                                #
#................###########........#                                #
#..........................#........#                                #
##..#########....#.........#........#                                #
#.....|  |.+#....#.........#........#                                #
#..... -- ..#....#.........#........#                                #
#...........#....#.........#........#                                #
######################################################################
