######################################################################
#...#..........#..#.....##....###...#....##...#....#..#...#.####...#.#
#.#...#######..##.#..#..##..#...#.#...#.#.#..#...#......#.....#..#...#
#..#.##...# #........#..#...#######.#.....#....#...#..#..###.....#...#
##.#..#.#..##..##.####....#.....#...##..#.##########..##########.....#
#..##.#.#.#####......#. #.#........ #..#..#.................#...####.#
#.####..#.....########...........~~~###...##########..#####.#..#.....#
#.# #..###### #.....########...~~~~~##[.].#...............#.....# [.]#
#.#......... ##..#..........~~~~~~~~################..################
#.######## #  #..#...#######~~~~~~~~...............#..#.............%#
#...........#...##............~~~~~~...............#..#.............%#
#############....#...#######..~~~~~~################..################
#...........#....#.........#...~~~~~#................................#
#....|  |...#....#.........#....~~~~#................................#
#########...#..............#.......~#................................#
#................###########........#................................#
#..........................#........#................................#
##..#########....#.........#........#...............[%]..............#
#.....|  |.+#....#.........#........#................................#
#..... -- ..#....#.........#........#................................#
#...........#....#.........#........#................................#
######################################################################
