######################################################################
#...#..........#..#.....##....###...#....##...#....#..#...#.####...#.#
#.#...#######..##.#..#..##..#...#.#...#.#.#..#...#..... #.....#..#...#
#..#.##...# #........#..#...#######.#.....#....#...#..#  ###.....#...#
##.#..#.#..##  ## ####....#.....#...##..#.##########..##########.....#
#..##.#.#.#####......#. #.#........ #..#..#.................#...####.#
#.####..#.....########...........~~~###...##########..#####.#..#.....#
#.# #..###### #.....########...~~~~~##[.].#...............#.....# [.]#
#.#......... ##..#..........~~~~~~~~################..################
#.######## #  #..#...#######~~~~~~~~................................@#
#...........#...##............~~~~~~................................@#
#############....#...#######..~~~~~~################..################
#...........#....#.........#...~~~~~#................................#
#....|  |...#....#.........#....~~~~#................................#
#########...#..............#.......~#................................#
#................###########........#................................#
#..........................#........#................................#
##..#########....#.........#........#................................#
#.....|  |.+#....#.........#........#................................#
#..... -- ..#....#.........#........#................................#
#...........#....#.........#........#................................#
######################################################################
