                                                                      
 m    m        mmmmm        m     m mmmmm  mm   m mmmmm    mm   mmmmm 
 #    #        #   "#       #  #  #   #    #"m  # #   "#   ##   #   "#
 #    #        #mmmm"       " #"# #   #    # #m # #mmmm"  #  #  #mmmm"
 #    #        #   "m        ## ##"   #    #  # # #   "m  #mm#  #   "m
 "mmmm"        #    "        #   #  mm#mm  #   ## #    " #    # #    "
                                                                      
 *********************************************************************
**********************************************************************
**********************************************************************
**********************************************************************
**********************************************************************
**********************************************************************
**********************************************************************
**********************************************************************
**********************************************************************
**********************************************************************
**********************************************************************
**********************************************************************
**********************************************************************
**********************************************************************
**********************************************************************
